ABL = "countries/Abelam.txt"
ABE = "countries/Abesia.txt"
ABI = "countries/Abi.txt"
ABY = "countries/Abyssinia.txt"
ACA = "countries/Acadia.txt"
ACE = "countries/Aceh.txt"
ACH = "countries/Acholia.txt"
ACY = "countries/Achysia.txt"
ACU = "countries/Acuguay.txt"
AGA = "countries/Agasymbia.txt"
AGU = "countries/Agurania.txt"
AHO = "countries/Ahom.txt"
AIG = "countries/Aigun.txt"
AIW = "countries/Aiwoio.txt"
ALC = "countries/Alaclufia.txt"
ALN = "countries/Alania.txt"
ABA = "countries/Albania.txt"
ALB = "countries/Alberta.txt"
ALE = "countries/Aleut.txt"
ALM = "countries/Almany.txt"
ALR = "countries/Alor.txt"
ALO = "countries/Alothia.txt"
ALA = "countries/Altavia.txt"
ALT = "countries/Altin.txt"
ALI = "countries/Altishar.txt"
ALU = "countries/Aluku.txt"
AMO = "countries/Amadores.txt"
AAL = "countries/Amala.txt"
AMA = "countries/Ambarbakini.txt"
AMB = "countries/Ambozes.txt"
AMD = "countries/Amdow.txt"
AEL = "countries/Amel.txt"
AME = "countries/America.txt"
AMR = "countries/Amerta.txt"
III = "countries/Ami.txt"
AMI = "countries/Amijara.txt"
AML = "countries/Amludive.txt"
AMU = "countries/Amugulam.txt"
ANC = "countries/Anacane.txt"
ANM = "countries/Andamana.txt"
ADI = "countries/Andia.txt"
ANR = "countries/Andira.txt"
ANE = "countries/Anema.txt"
ANG = "countries/Angol.txt"
ANO = "countries/Angor.txt"
ANA = "countries/Anian.txt"
ANI = "countries/Anishinabee.txt"
ANL = "countries/Anlong.txt"
ANN = "countries/Annam.txt"
ANU = "countries/Antigua.txt"
ANT = "countries/Antonines.txt"
ANZ = "countries/Anzigo.txt"
AOT = "countries/Aotearoa.txt"
APA = "countries/Apacheria.txt"
ARB = "countries/Arabana.txt"
ARA = "countries/Arabia.txt"
ARF = "countries/Arafuna.txt"
ARO = "countries/Aragon.txt"
ARU = "countries/Araguay.txt"
AAN = "countries/Aran.txt"
ARP = "countries/Arapesa.txt"
ARS = "countries/Arasudra.txt"
ARC = "countries/Araucania.txt"
ARG = "countries/Argentina.txt"
ARJ = "countries/Arigaja.txt"
ARN = "countries/Arinivia.txt"
ARI = "countries/Arizona.txt"
ARK = "countries/Arkaru.txt"
ARM = "countries/Armenia.txt"
ART = "countries/Armtal.txt"
RRA = "countries/Aru.txt"
AUB = "countries/Arubo.txt"
ARY = "countries/Arunya.txt"
ASC = "countries/Ascaria.txt"
ASE = "countries/Ascensions.txt"
ASP = "countries/Aspland.txt"
ASA = "countries/Assam.txt"
ASS = "countries/Assandia.txt"
ASB = "countries/Astaboria.txt"
AST = "countries/Astribana.txt"
ASY = "countries/Astyria.txt"
ATM = "countries/Atama.txt"
ATW = "countries/Atawasi.txt"
ATH = "countries/Athabasca.txt"
ATA = "countries/Athagosia.txt"
AUC = "countries/Auckland.txt"
AUS = "countries/Australia.txt"
AUT = "countries/Auton.txt"
AVA = "countries/Avalon.txt"
AVN = "countries/Avania.txt"
AVR = "countries/Avaria.txt"
AYU = "countries/Ayutina.txt"
AZE = "countries/Azeria.txt"
AZL = "countries/Azlana.txt"
AZO = "countries/Azores.txt"
BAB = "countries/Babria.txt"
BCE = "countries/Bacen.txt"
BAA = "countries/Bacia.txt"
BAC = "countries/Bactria.txt"
BGI = "countries/Baginda.txt"
BAG = "countries/Bagrimia.txt"
BAH = "countries/Bahama.txt"
BAJ = "countries/Bajau.txt"
BLA = "countries/Baleare.txt"
BAO = "countries/Baledores.txt"
BLI = "countries/Bali.txt"
BAM = "countries/Balima.txt"
BAL = "countries/Baloch.txt"
BAN = "countries/Banabum.txt"
BAD = "countries/Bandan.txt"
BNG = "countries/Bangi.txt"
BAU = "countries/Banuba.txt"
BAR = "countries/Barainia.txt"
BRB = "countries/Barbados.txt"
BBU = "countries/Barbuda.txt"
BRM = "countries/Barima.txt"
BAI = "countries/Barria.txt"
BAS = "countries/Basgaria.txt"
BSI = "countries/Basi.txt"
BAT = "countries/Bastar.txt"
BTA = "countries/Batan.txt"
BAE = "countries/Batek.txt"
BAV = "countries/Bavara.txt"
BEA = "countries/Belamora.txt"
BEL = "countries/Belarus.txt"
BET = "countries/Belitung.txt"
BEN = "countries/Bengal.txt"
BEI = "countries/Benin.txt"
BEQ = "countries/Bequiya.txt"
BER = "countries/Berar.txt"
BEM = "countries/Bermuda.txt"
BES = "countries/Besserabia.txt"
BTW = "countries/Betawa.txt"
BEW = "countries/Bewa.txt"
BEY = "countries/Beya.txt"
BHU = "countries/Bhutan.txt"
BIF = "countries/Biafra.txt"
BIA = "countries/Biarmland.txt"
BID = "countries/Bidorame.txt"
BIL = "countries/Bilingjal.txt"
BIN = "countries/Bintan.txt"
BIY = "countries/Bisaya.txt"
BIS = "countries/Bissa.txt"
BIR = "countries/Biyar.txt"
BLE = "countries/Blemysia.txt"
BOH = "countries/Boheme.txt"
BHO = "countries/Bohol.txt"
BOL = "countries/Bolivia.txt"
BOB = "countries/Bombay.txt"
BOM = "countries/Bomket.txt"
BON = "countries/Bonebele.txt"
BOP = "countries/Bopedi.txt"
BOR = "countries/Borgu.txt"
BOI = "countries/Bornica.txt"
BOO = "countries/Boroco.txt"
BOS = "countries/Bosnia.txt"
BOA = "countries/Botrajistan.txt"
BOT = "countries/Botswana.txt"
BRD = "countries/Bramidores.txt"
BRA = "countries/Brazil.txt"
BRI = "countries/Brigantia.txt"
BRC = "countries/Bruchia.txt"
BRU = "countries/Bruni.txt"
BLK = "countries/Bulaka.txt"
BUL = "countries/Bulgaria.txt"
BUA = "countries/Bumang.txt"
BUN = "countries/Bundria.txt"
BRR = "countries/Burar.txt"
BUE = "countries/Burelia.txt"
BUK = "countries/Burkina.txt"
BUM = "countries/Burma.txt"
BUR = "countries/Buryat.txt"
CAB = "countries/Cabardia.txt"
CAE = "countries/Caenia.txt"
CAF = "countries/Cafa.txt"
CAI = "countries/Cainame.txt"
CAA = "countries/Calasia.txt"
CAD = "countries/Caledonia.txt"
CAL = "countries/California.txt"
CAM = "countries/Camaria.txt"
CAN = "countries/Canada.txt"
CAT = "countries/Cantabria.txt"
CAP = "countries/Capadocia.txt"
CAO = "countries/Cape Leone.txt"
CPE = "countries/Cape Monte.txt"
CAV = "countries/Cape Verde.txt"
CPP = "countries/Cappia.txt"
CAH = "countries/Carinthia.txt"
CRM = "countries/Carmel.txt"
CAS = "countries/Carolines.txt"
CAR = "countries/Carpathia.txt"
CTA = "countries/Catalia.txt"
CAY = "countries/Cayenne.txt"
CAU = "countries/Cayune.txt"
CAZ = "countries/Cazaran.txt"
CEI = "countries/Ceibal.txt"
CEL = "countries/Celadores.txt"
CEY = "countries/Ceylon.txt"
CHD = "countries/Chaldia.txt"
CHT = "countries/Chalnulth.txt"
CHM = "countries/Champa.txt"
HAO = "countries/Chaon.txt"
CHA = "countries/Chatisgara.txt"
CHR = "countries/Cheremisia.txt"
CHB = "countries/Chernobyl.txt"
CHE = "countries/Chernorus.txt"
CER = "countries/Cherokee.txt"
CHC = "countries/Chilcot.txt"
CHN = "countries/China.txt"
CHS = "countries/Chitralistan.txt"
CHK = "countries/Chokan.txt"
CHL = "countries/Cholnata.txt"
CHP = "countries/Chopan.txt"
CHO = "countries/Chorasmia.txt"
COA = "countries/Choria.txt"
CHG = "countries/Chugach.txt"
CHU = "countries/Chukcha.txt"
CIL = "countries/Cilicia.txt"
CIM = "countries/Cimmeria.txt"
CIR = "countries/Circassia.txt"
COL = "countries/Colchia.txt"
COM = "countries/Comancheria.txt"
CON = "countries/Congo.txt"
COO = "countries/Coorg.txt"
COZ = "countries/Corazal.txt"
COC = "countries/Corciny.txt"
COR = "countries/Cordia.txt"
COI = "countries/Corrimia.txt"
COU = "countries/Cozumel.txt"
CRI = "countries/Crimia.txt"
CRO = "countries/Croatia.txt"
CUB = "countries/Cuba.txt"
CUM = "countries/Cumbreland.txt"
CYP = "countries/Cypria.txt"
CYR = "countries/Cyrevia.txt"
DGA = "countries/Daga.txt"
DAG = "countries/Dagbon.txt"
DAA = "countries/Daha.txt"
DAH = "countries/Daharo.txt"
DAO = "countries/Dahome.txt"
DAI = "countries/Dali.txt"
DAL = "countries/Dalmatia.txt"
DAR = "countries/Damar.txt"
DAM = "countries/Damarana.txt"
DAU = "countries/Damutia.txt"
DNA = "countries/Dana.txt"
DAN = "countries/Danmark.txt"
DEM = "countries/Dematia.txt"
DES = "countries/Deseret.txt"
DEA = "countries/Devaja.txt"
DEV = "countries/Devia.txt"
DEL = "countries/Devland.txt"
DIE = "countries/Dierna.txt"
DIM = "countries/Dimas.txt"
DIP = "countries/Dipal.txt"
DIW = "countries/Diwarasa.txt"
DJA = "countries/Dja.txt"
DRE = "countries/Drenjong.txt"
DRU = "countries/Drukyul.txt"
DUM = "countries/Dumarune.txt"
DUA = "countries/Duran.txt"
DUR = "countries/Durgara.txt"
DUS = "countries/Dusun.txt"
DZU = "countries/Dzungar.txt"
EBO = "countries/Ebony Coast.txt"
ECU = "countries/Ecuador.txt"
EFA = "countries/Efati.txt"
EGY = "countries/Egypt.txt"
EKA = "countries/Ekara.txt"
ELE = "countries/Elevala.txt"
ELG = "countries/Elgonia.txt"
ELI = "countries/Elia.txt"
ELV = "countries/Elvire.txt"
EMI = "countries/Emira.txt"
ENA = "countries/Enaria.txt"
END = "countries/Endor.txt"
EGA = "countries/Enga.txt"
ENL = "countries/England.txt"
EPS = "countries/Epsumba.txt"
ERI = "countries/Eriwati.txt"
ESA = "countries/Esa.txt"
ESM = "countries/Esmiria.txt"
ESS = "countries/Essequibo.txt"
EST = "countries/Estland.txt"
ETH = "countries/Ethiopia.txt"
ETU = "countries/Etuguay.txt"
ETL = "countries/Etula.txt"
ETR = "countries/Eturia.txt"
EUC = "countries/Euchee.txt"
EWA = "countries/Ewanora.txt"
FAI = "countries/Fairland.txt"
FAD = "countries/Faldive.txt"
FAL = "countries/Sulu.txt"
FAM = "countries/Famagusta.txt"
FEL = "countries/Felitia.txt"
FER = "countries/Fernandines.txt"
FIN = "countries/Finnland.txt"
FLA = "countries/Flanders.txt"
FOJ = "countries/Fojen.txt"
FOR = "countries/Formosa.txt"
FRN = "countries/France.txt"
FRI = "countries/Frisse.txt"
FUS = "countries/Fusan.txt"
FUT = "countries/Futuna.txt"
GAB = "countries/Gabon.txt"
GAJ = "countries/Gaja.txt"
GAP = "countries/Galapagos.txt"
GAL = "countries/Galatia.txt"
GAV = "countries/Galedive.txt"
GLE = "countries/Galela.txt"
GAC = "countries/Galicia.txt"
GAI = "countries/Galinne.txt"
GAM = "countries/Gamun.txt"
GAD = "countries/Gandia.txt"
GAN = "countries/Ganj.txt"
GAA = "countries/Garawara.txt"
RAI = "countries/Gari.txt"
GAR = "countries/Garmantia.txt"
GAE = "countries/Gartsen.txt"
GRU = "countries/Garu.txt"
GAU = "countries/Garuda.txt"
GAW = "countries/Garwal.txt"
GAS = "countries/Gasaria.txt"
GAT = "countries/Gatsim.txt"
GAY = "countries/Gayor.txt"
GDI = "countries/Gediri.txt"
GED = "countries/Gedrosia.txt"
GEA = "countries/Gela.txt"
GEG = "countries/Gelgia.txt"
GEI = "countries/Gelilia.txt"
GEL = "countries/Gellia.txt"
GEN = "countries/Gentmark.txt"
GEM = "countries/Germany.txt"
GEH = "countries/Gerthland.txt"
GEC = "countries/Getica.txt"
GEU = "countries/Getrugia.txt"
GET = "countries/Getulia.txt"
GBR = "countries/Gibraltar.txt"
GIG = "countries/Gigan.txt"
GIH = "countries/Gihonia.txt"
GIJ = "countries/Gija.txt"
GIN = "countries/Gilang.txt"
GIL = "countries/Gilania.txt"
GIM = "countries/Gimbiyu.txt"
GIA = "countries/Giran.txt"
GIB = "countries/Girba.txt"
GII = "countries/Giringun.txt"
GIR = "countries/Girlinga.txt"
GIT = "countries/Githabul.txt"
GAG = "countries/Goa.txt"
GOE = "countries/Goares.txt"
GOH = "countries/Gohire.txt"
GGG = "countries/Gol.txt"
GOA = "countries/Golan.txt"
GOL = "countries/Gold Coast.txt"
GOO = "countries/Golok.txt"
GOM = "countries/Gomeria.txt"
GON = "countries/Gondwana.txt"
GOR = "countries/Gorania.txt"
GOW = "countries/Gowa.txt"
GOY = "countries/Goyo.txt"
GRC = "countries/Greece.txt"
GRE = "countries/Grenland.txt"
GUJ = "countries/Gujarat.txt"
GLA = "countries/Gulaga.txt"
GUG = "countries/Gulanga.txt"
GLU = "countries/Gulumirgin.txt"
GUL = "countries/Gulwara.txt"
GUM = "countries/Gumbakana.txt"
UNN = "countries/Gun.txt"
GUD = "countries/Gundara.txt"
GUN = "countries/Guntaga.txt"
GRA = "countries/Guragun.txt"
GUA = "countries/Gurama.txt"
GUR = "countries/Gurgiri.txt"
GUI = "countries/Guria.txt"
GRI = "countries/Gurin.txt"
GUK = "countries/Gurkha.txt"
GRN = "countries/Gurun.txt"
GUU = "countries/Gurunji.txt"
GUT = "countries/Gutland.txt"
GWL = "countries/Gwelow.txt"
GWE = "countries/Gwennland.txt"
GYA = "countries/Gyalrong.txt"
GYM = "countries/Gyam.txt"
HAD = "countries/Hadenosonee.txt"
HAA = "countries/Haida.txt"
HAI = "countries/Haisla.txt"
HAT = "countries/Haiti.txt"
HAK = "countries/Haklow.txt"
HAL = "countries/Haltia.txt"
HAM = "countries/Hamasenia.txt"
HAR = "countries/Harlia.txt"
HAU = "countries/Haru.txt"
HSA = "countries/Hasawati.txt"
HAH = "countries/Hashan.txt"
HAS = "countries/Hassia.txt"
HAW = "countries/Hawaii.txt"
HAY = "countries/Hayan.txt"
HET = "countries/Heltsuk.txt"
HEL = "countries/Helvetium.txt"
HEY = "countries/Heyak.txt"
HOK = "countries/Hokkien.txt"
HON = "countries/Hongkong.txt"
HOR = "countries/Horatia.txt"
HUL = "countries/Huli.txt"
HUM = "countries/Humbria.txt"
HUN = "countries/Hungaria.txt"
HUZ = "countries/Hunzistan.txt"
HUR = "countries/Hurria.txt"
HYD = "countries/Hydrimia.txt"
HYR = "countries/Hyrcania.txt"
ICE = "countries/Iceland.txt"
ILA = "countries/Illawara.txt"
ILL = "countries/Illyria.txt"
INB = "countries/Inban.txt"
IRA = "countries/Iramanga.txt"
IRE = "countries/Ireland.txt"
IRI = "countries/Irian.txt"
ISR = "countries/Israel.txt"
IST = "countries/Istury.txt"
ITL = "countries/Italy.txt"
ITY = "countries/Itysia.txt"
IVE = "countries/Iveria.txt"
IVO = "countries/Ivory Coast.txt"
JAB = "countries/Jabura.txt"
JAD = "countries/Jada.txt"
JAG = "countries/Jagana.txt"
JAL = "countries/Jala.txt"
JAM = "countries/Jamaica.txt"
JAN = "countries/Janagata.txt"
JAA = "countries/Japan.txt"
JAI = "countries/Japi.txt"
JRA = "countries/Jarama.txt"
JAR = "countries/Jarkhand.txt"
JAU = "countries/Jarun.txt"
JAT = "countries/Jatiwara.txt"
JAV = "countries/Java.txt"
JAW = "countries/Jawi.txt"
JIB = "countries/Jiban.txt"
JIN = "countries/Jingila.txt"
JIR = "countries/Jirna.txt"
JIT = "countries/Jitinu.txt"
JOH = "countries/Johor.txt"
JOA = "countries/Joram.txt"
JOR = "countries/Jordan.txt"
JOS = "countries/Joson.txt"
JUJ = "countries/Jujala.txt"
KAC = "countries/Kachin.txt"
KIA = "countries/Kairan.txt"
KAK = "countries/Kakadu.txt"
KLA = "countries/Kala.txt"
KAL = "countries/Kalahari.txt"
KAI = "countries/Kalimantan.txt"
KAM = "countries/Kama.txt"
KMA = "countries/Kamar.txt"
KMS = "countries/Kamasa.txt"
KAO = "countries/Kamorta.txt"
KAN = "countries/Kanton.txt"
KAG = "countries/Kapingamarangi.txt"
KAP = "countries/Kapudira.txt"
KAA = "countries/Karan.txt"
KRA = "countries/Karasa.txt"
KAD = "countries/Kardasa.txt"
KRK = "countries/Karka.txt"
KAR = "countries/Karnataka.txt"
KAH = "countries/Kashin.txt"
KAS = "countries/Kasmiristan.txt"
KAT = "countries/Katesh.txt"
KTO = "countries/Kator.txt"
KAV = "countries/Kavana.txt"
KAY = "countries/Kaya.txt"
KAZ = "countries/Kazembe.txt"
KEJ = "countries/Keja.txt"
KEN = "countries/Kenan.txt"
KEE = "countries/Kenedugu.txt"
KER = "countries/Kerala.txt"
KHK = "countries/Khakis.txt"
KHA = "countries/Khalkin.txt"
KHM = "countries/Kham.txt"
KHR = "countries/Kharichet.txt"
KHU = "countries/Khumer.txt"
KIL = "countries/Kilivila.txt"
KIN = "countries/Kinar.txt"
KIO = "countries/Kioweria.txt"
KIR = "countries/Kirin.txt"
KIT = "countries/Kirtinara.txt"
KSA = "countries/Kisar.txt"
KIS = "countries/Kissimee.txt"
KOC = "countries/Kochopi.txt"
KOH = "countries/Kohistan.txt"
KOL = "countries/Kolma.txt"
KOU = "countries/Kolu.txt"
KOA = "countries/Komara.txt"
KOO = "countries/Komodo.txt"
KOM = "countries/Komox.txt"
KON = "countries/Konkan.txt"
KOR = "countries/Koru.txt"
KOT = "countries/Kotsonga.txt"
KOV = "countries/Kovenda.txt"
KUX = "countries/Kuaxhosa.txt"
KUA = "countries/Kuazulu.txt"
KUL = "countries/Kulim.txt"
KUI = "countries/Kunaii.txt"
KUN = "countries/Kunmin.txt"
KUP = "countries/Kupang.txt"
KUR = "countries/Kurland.txt"
KUU = "countries/Kurum.txt"
KRU = "countries/Kurun.txt"
KUC = "countries/Kutch.txt"
KUT = "countries/Kuti.txt"
KWA = "countries/Kwakiut.txt"
KWE = "countries/Kweyan.txt"
KYU = "countries/Kyutsu.txt"
LAL = "countries/Labala.txt"
LAR = "countries/Labradores.txt"
LAB = "countries/Labrellia.txt"
LBU = "countries/Labuan.txt"
LAC = "countries/Lacan.txt"
LAD = "countries/Ladakh.txt"
LAK = "countries/Laknam.txt"
LAA = "countries/Lamdam.txt"
LAE = "countries/Lampedusa.txt"
LAU = "countries/Lampung.txt"
LAM = "countries/Lamut.txt"
LAF = "countries/Lanfong.txt"
LAG = "countries/Langasuka.txt"
LAN = "countries/Lansang.txt"
LAI = "countries/Lapita.txt"
LAP = "countries/Lappmark.txt"
LRD = "countries/Lardi.txt"
LAS = "countries/Lasadive.txt"
ULA = "countries/Lau.txt"
LAW = "countries/Lawan.txt"
LWU = "countries/Lawukalawa.txt"
LAZ = "countries/Lazarines.txt"
LEB = "countries/Lebanon.txt"
LEI = "countries/Leipan.txt"
LEL = "countries/Lelu.txt"
LEP = "countries/Leputhi.txt"
LER = "countries/Lerine.txt"
LEO = "countries/Lesotho.txt"
LES = "countries/Leswazi.txt"
LET = "countries/Lethland.txt"
LTI = "countries/Leti.txt"
LII = "countries/Liamuiga.txt"
LIB = "countries/Liberia.txt"
LIE = "countries/Liberum.txt"
LIF = "countries/Lifu.txt"
LIG = "countries/Ligor.txt"
LIU = "countries/Ligury.txt"
LIH = "countries/Lihir.txt"
LIL = "countries/Lilwat.txt"
LIM = "countries/Lima.txt"
LIA = "countries/Lingan.txt"
LIN = "countries/Linglam.txt"
LIP = "countries/Lipka.txt"
LIR = "countries/Lire.txt"
LIT = "countries/Lithuany.txt"
LOA = "countries/Loango.txt"
LOM = "countries/Lombardy.txt"
LOB = "countries/Lombok.txt"
LOV = "countries/Lomvia.txt"
LOT = "countries/Lota.txt"
LOR = "countries/Lovaria.txt"
LUM = "countries/Lumala.txt"
LUS = "countries/Lusace.txt"
LUW = "countries/Luwu.txt"
LYC = "countries/Lycia.txt"
MCA = "countries/Macau.txt"
MAA = "countries/Macia.txt"
MAC = "countries/Macrobia.txt"
MAE = "countries/Madeira.txt"
MAD = "countries/Madigana.txt"
MDU = "countries/Madura.txt"
MGA = "countries/Maga.txt"
MAG = "countries/Magania.txt"
MGT = "countries/Magata.txt"
MAY = "countries/Magaya.txt"
MHA = "countries/Mahaga.txt"
MAH = "countries/Maharath.txt"
MHI = "countries/Mahisa.txt"
MHO = "countries/Mahorga.txt"
MKA = "countries/Makah.txt"
MAK = "countries/Malagaskara.txt"
MLT = "countries/Malata.txt"
MLA = "countries/Malayala.txt"
MAV = "countries/Maldive.txt"
MLE = "countries/Malekula.txt"
MLI = "countries/Malina.txt"
MTA = "countries/Malta.txt"
MAL = "countries/Malva.txt"
MAM = "countries/Mamar.txt"
MAT = "countries/Mammoth Island.txt"
MND = "countries/Mandailing.txt"
MNR = "countries/Mandara.txt"
MNL = "countries/Mangal.txt"
MNG = "countries/Mangareva.txt"
MAI = "countries/Manitoba.txt"
MAJ = "countries/Manjur.txt"
MAB = "countries/Manuba.txt"
MRA = "countries/Marala.txt"
MRE = "countries/Mare.txt"
MRG = "countries/Margh.txt"
ARM = "countries/Mari.txt"
MRI = "countries/Marija.txt"
MRN = "countries/Maringara.txt"
MAR = "countries/Marmoria.txt"
MRO = "countries/Marotiri.txt"
MAO = "countries/Maroun.txt"
MAW = "countries/Marwar.txt"
MAS = "countries/Masaria.txt"
MSI = "countries/Masikh.txt"
MSK = "countries/Maskardive.txt"
MAU = "countries/Mauretania.txt"
MEC = "countries/Mecuria.txt"
MED = "countries/Media.txt"
MEK = "countries/Meka.txt"
MLL = "countries/Melalon.txt"
MEL = "countries/Melpa.txt"
MEO = "countries/Menominee.txt"
ERA = "countries/Mera.txt"
MEA = "countries/Merabia.txt"
MER = "countries/Merina.txt"
MIM = "countries/Miamee.txt"
MIG = "countries/Migmagee.txt"
MIK = "countries/Mikir.txt"
MIH = "countries/Minahasa.txt"
MIS = "countries/Minasera.txt"
MIN = "countries/Minlam.txt"
MIA = "countries/Mirang.txt"
MIR = "countries/Miri.txt"
MOL = "countries/Moldores.txt"
MOI = "countries/Moni.txt"
MON = "countries/Montenegro.txt"
MOR = "countries/Mordia.txt"
MOO = "countries/Morota.txt"
MOS = "countries/Mossilia.txt"
MOT = "countries/Motu.txt"
MOU = "countries/Mouling.txt"
UAU = "countries/Mua.txt"
MDA = "countries/Mudan.txt"
MUG = "countries/Mugrala.txt"
MUI = "countries/Mukini.txt"
MUY = "countries/Mukyu.txt"
MNA = "countries/Muna.txt"
MUD = "countries/Mundar.txt"
MUN = "countries/Mungprak.txt"
MUK = "countries/Munkland.txt"
MUE = "countries/Munsee.txt"
MUA = "countries/Muskagee.txt"
MUS = "countries/Muskigumee.txt"
MYR = "countries/Myrria.txt"
NAG = "countries/Nagabujan.txt"
NAH = "countries/Nahor.txt"
NAK = "countries/Nakan.txt"
NAD = "countries/Namden.txt"
NAM = "countries/Namiba.txt"
NAO = "countries/Namonui.txt"
NAN = "countries/Nanchew.txt"
NAI = "countries/Narine.txt"
NAR = "countries/Narnia.txt"
NAA = "countries/Nasalor.txt"
NAS = "countries/Nashtee.txt"
NAU = "countries/Nauka.txt"
NUU = "countries/Nauru.txt"
NAV = "countries/Navarre.txt"
NAW = "countries/Nawar.txt"
NEH = "countries/Nehan.txt"
NED = "countries/Nendoa.txt"
NEN = "countries/Nengoni.txt"
NEP = "countries/Nepal.txt"
NES = "countries/Nesland.txt"
NEV = "countries/Nevis.txt"
NIA = "countries/Niasa.txt"
NIC = "countries/Nicaragua.txt"
NIF = "countries/Niflbard.txt"
NIG = "countries/Nigeria.txt"
NIK = "countries/Nikobara.txt"
NIL = "countries/Niladesh.txt"
NIN = "countries/Ninivia.txt"
NIS = "countries/Nisga.txt"
NIW = "countries/Niwui.txt"
NUB = "countries/Nubia.txt"
NUD = "countries/Nudan.txt"
NUK = "countries/Nukuoro.txt"
NUM = "countries/Numidia.txt"
NUN = "countries/Nunangats.txt"
NUR = "countries/Nuristan.txt"
NUX = "countries/Nuxalk.txt"
NYM = "countries/Nymael.txt"
OBA = "countries/Obara.txt"
OCA = "countries/Ocarasta.txt"
ODI = "countries/Odiras.txt"
ORR = "countries/Oro.txt"
ORO = "countries/Oromia.txt"
ORN = "countries/Orona.txt"
OSL = "countries/Osland.txt"
OSS = "countries/Ossetia.txt"
OTO = "countries/Otomagan.txt"
OYS = "countries/Oyssinia.txt"
PAD = "countries/Padun.txt"
PHN = "countries/Pahan.txt"
PAO = "countries/Pahoturi.txt"
PAJ = "countries/Pajistan.txt"
PAK = "countries/Pakistan.txt"
PAE = "countries/Palestine.txt"
PAL = "countries/Palmares.txt"
PAM = "countries/Pamak.txt"
PNA = "countries/Panarasa.txt"
PND = "countries/Pandala.txt"
PNT = "countries/Pantallera.txt"
PAN = "countries/Pantanales.txt"
PNR = "countries/Pantar.txt"
PAR = "countries/Paraguay.txt"
PRS = "countries/Parasa.txt"
PAS = "countries/Parasia.txt"
PAH = "countries/Parthia.txt"
PAT = "countries/Patagonia.txt"
PAA = "countries/Pathania.txt"
PEK = "countries/Pekow.txt"
PEN = "countries/Penang.txt"
PEA = "countries/Perak.txt"
PEI = "countries/Perim.txt"
PES = "countries/Persia.txt"
PER = "countries/Peru.txt"
PEC = "countries/Pescadores.txt"
PHA = "countries/Phasania.txt"
PHE = "countries/Pheran.txt"
PHI = "countries/Philippines.txt"
PHO = "countries/Phoenixes.txt"
PHY = "countries/Phyrnia.txt"
PIL = "countries/Pilibara.txt"
PIT = "countries/Pitaguay.txt"
POL = "countries/Polony.txt"
POM = "countries/Pomerany.txt"
PON = "countries/Ponapi.txt"
POG = "countries/Pongfong.txt"
POR = "countries/Portugal.txt"
POU = "countries/Poumu.txt"
POY = "countries/Poyan.txt"
PRA = "countries/Prabang.txt"
PUL = "countries/Puli.txt"
PUI = "countries/Punice.txt"
PUN = "countries/Punjab.txt"
PUT = "countries/Punturala.txt"
QUA = "countries/Quapem.txt"
QUR = "countries/Quarasao.txt"
QUN = "countries/Queranda.txt"
QUE = "countries/Querchira.txt"
QUC = "countries/Quica.txt"
QUL = "countries/Quiliut.txt"
QUI = "countries/Quiscaya.txt"
RAH = "countries/Rahania.txt"
RAJ = "countries/Rajampat.txt"
RAG = "countries/Rakahanga.txt"
RAK = "countries/Rakhine.txt"
RAM = "countries/Raman.txt"
RAU = "countries/Ramu.txt"
RAN = "countries/Rangia.txt"
RAP = "countries/Ranpu.txt"
RAA = "countries/Rapanui.txt"
RAO = "countries/Rarotonga.txt"
RAS = "countries/Rasawa.txt"
RAW = "countries/Rawa.txt"
RAR = "countries/Rawarat.txt"
REJ = "countries/Rejang.txt"
REK = "countries/Rekohua.txt"
RHI = "countries/Rhimeland.txt"
RHO = "countries/Rhodesia.txt"
RIH = "countries/Rihnam.txt"
RIT = "countries/Ritwan.txt"
RIW = "countries/Riwat.txt"
ROH = "countries/Rohi.txt"
RON = "countries/Rondia.txt"
ROT = "countries/Rotoka.txt"
ROV = "countries/Rovuma.txt"
RUB = "countries/Rubi.txt"
RUG = "countries/Rugara.txt"
RUM = "countries/Ruma.txt"
RMU = "countries/Rumu.txt"
RUU = "countries/Rumud.txt"
RUR = "countries/Rura.txt"
RUO = "countries/Ruson.txt"
RUS = "countries/Russia.txt"
RUT = "countries/Ruthenia.txt"
RUL = "countries/Rutulia.txt"
RUW = "countries/Ruwana.txt"
RYC = "countries/Rychia.txt"
RYU = "countries/Ryukyu.txt"
SAB = "countries/Sabah.txt"
SBN = "countries/Sabana.txt"
SBA = "countries/Sabar.txt"
SBI = "countries/Sabia.txt"
SAC = "countries/Saconia.txt"
SAD = "countries/Sadagia.txt"
SAH = "countries/Sahu.txt"
SAG = "countries/Saigon.txt"
SIP = "countries/Saipan.txt"
SAK = "countries/Saka.txt"
SAA = "countries/Sakalava.txt"
SAW = "countries/Salawati.txt"
SAI = "countries/Salia.txt"
SAL = "countries/Salur.txt"
SAO = "countries/Samoa.txt"
SMS = "countries/Samsok.txt"
SAM = "countries/Samura.txt"
SAU = "countries/Samuria.txt"
SNG = "countries/Sangir.txt"
SAJ = "countries/Sanjan.txt"
SAT = "countries/Sant.txt"
SAP = "countries/Sapicia.txt"
SPU = "countries/Sapusawuni.txt"
SAR = "countries/Sarawak.txt"
SAN = "countries/Sardiny.txt"
SRK = "countries/Sark.txt"
SAS = "countries/Sascatchewa.txt"
STR = "countries/Satripu.txt"
SAV = "countries/Savu.txt"
SAX = "countries/Saxony.txt"
SAY = "countries/Sayan.txt"
SCO = "countries/Scotland.txt"
SCY = "countries/Scythia.txt"
SEB = "countries/Sebet.txt"
SEC = "countries/Sechelt.txt"
SEK = "countries/Sekan.txt"
SEL = "countries/Selkland.txt"
SED = "countries/Sendarawasi.txt"
SEN = "countries/Senegalia.txt"
SNT = "countries/Sentana.txt"
SET = "countries/Sentarna.txt"
SEM = "countries/Seram.txt"
SEA = "countries/Seravia.txt"
SEI = "countries/Serbia.txt"
SRM = "countries/Sermata.txt"
SEO = "countries/Serong.txt"
SER = "countries/Serthia.txt"
SHA = "countries/Shan.txt"
SHN = "countries/Shanon.txt"
SHR = "countries/Sherpa.txt"
SHE = "countries/Shetland.txt"
SHO = "countries/Shona.txt"
SHS = "countries/Shosan.txt"
SHU = "countries/Shuswap.txt"
SIA = "countries/Siam.txt"
SCA = "countries/Sicargia.txt"
SIC = "countries/Sicily.txt"
SID = "countries/Siddirad.txt"
IKA = "countries/Sika.txt"
SKA = "countries/Sikang.txt"
SIH = "countries/Sikhim.txt"
SIE = "countries/Silese.txt"
SII = "countries/Silistria.txt"
SIL = "countries/Siluria.txt"
SIM = "countries/Simbal.txt"
SIR = "countries/Sinaria.txt"
SIN = "countries/Sind.txt"
SIO = "countries/Singapore.txt"
SNI = "countries/Sinivi.txt"
SIG = "countries/Sintaguay.txt"
SIU = "countries/Sipura.txt"
SIT = "countries/Sita.txt"
SIK = "countries/Sitka.txt"
SIV = "countries/Sivajaya.txt"
SKR = "countries/Skaroree.txt"
SKO = "countries/Skoltland.txt"
SLO = "countries/Slovenia.txt"
SOB = "countries/Sobrarba.txt"
SOC = "countries/Socotria.txt"
SOG = "countries/Sogdia.txt"
SOM = "countries/Somalia.txt"
SOU = "countries/Southafrica.txt"
SPA = "countries/Spain.txt"
SPI = "countries/Spice Coast.txt"
SPN = "countries/Spinrong.txt"
SUA = "countries/Suania.txt"
SUE = "countries/Suelia.txt"
SUK = "countries/Sulka.txt"
SUL = "countries/Sulu.txt"
SMA = "countries/Sumar.txt"
SUB = "countries/Sumbawa.txt"
SUI = "countries/Sumina.txt"
SUM = "countries/Sumir.txt"
SUN = "countries/Sunda.txt"
SUR = "countries/Suriname.txt"
SUV = "countries/Suvadive.txt"
SUW = "countries/Suwarga.txt"
SVA = "countries/Svalbard.txt"
SWE = "countries/Swedeland.txt"
SYA = "countries/Syrania.txt"
SYR = "countries/Syria.txt"
SZE = "countries/Szechuan.txt"
TAF = "countries/Tafahi.txt"
TAH = "countries/Taghur.txt"
TAI = "countries/Tagis.txt"
TAY = "countries/Tagychia.txt"
TAT = "countries/Tahiti.txt"
TAL = "countries/Tahltan.txt"
TAO = "countries/Tairona.txt"
TAW = "countries/Taiwan.txt"
TKH = "countries/Takharistan.txt"
TAK = "countries/Takhel.txt"
TAA = "countries/Talang.txt"
TLA = "countries/Talar.txt"
TAM = "countries/Taman.txt"
TMB = "countries/Tambora.txt"
TNA = "countries/Tana.txt"
TNB = "countries/Tanabala.txt"
TAN = "countries/Tanana.txt"
TNA = "countries/Tangali.txt"
TAE = "countries/Tangeria.txt"
TAG = "countries/Tanghut.txt"
TNI = "countries/Tanimbar.txt"
TNT = "countries/Tantan.txt"
TPA = "countries/Tapasaria.txt"
TAB = "countries/Taprobane.txt"
TAP = "countries/Tapuria.txt"
TRA = "countries/Taram.txt"
AAA = "countries/Tarana.txt"
TAR = "countries/Taregia.txt"
TRR = "countries/Tarire.txt"
TAS = "countries/Tasmania.txt"
TUK = "countries/Taumako.txt"
TAU = "countries/Tauria.txt"
TEL = "countries/Telangana.txt"
TEM = "countries/Temuhi.txt"
TEA = "countries/Teraina.txt"
TER = "countries/Teranga.txt"
TET = "countries/Tetan.txt"
TEX = "countries/Texas.txt"
THN = "countries/Tharanja.txt"
THA = "countries/Tharwagitam.txt"
THE = "countries/Thelemark.txt"
THU = "countries/Thunapa.txt"
THR = "countries/Thurata.txt"
TIC = "countries/Ticar.txt"
TIO = "countries/Tidor.txt"
TIG = "countries/Tigretia.txt"
TIU = "countries/Tiguri.txt"
TIL = "countries/Tilana.txt"
TIM = "countries/Timor.txt"
TID = "countries/Tinding.txt"
TIN = "countries/Tinthigia.txt"
TIA = "countries/Tirna.txt"
TIR = "countries/Tiuri.txt"
TLI = "countries/Tlinget.txt"
TOB = "countries/Tobago.txt"
TOG = "countries/Togo.txt"
TOK = "countries/Tokelau.txt"
TOA = "countries/Tolaga.txt"
TOI = "countries/Toli.txt"
TOL = "countries/Tolmon.txt"
TNG = "countries/Tonga.txt"
TON = "countries/Tongas.txt"
TOW = "countries/Towaii.txt"
TRB = "countries/Tribul.txt"
TRI = "countries/Triwara.txt"
TRU = "countries/Trung.txt"
TRV = "countries/Truvinia.txt"
TSA = "countries/Tsaiset.txt"
TSE = "countries/Tsedan.txt"
TSI = "countries/Tsimshan.txt"
TSU = "countries/Tsulan.txt"
TSR = "countries/Tsuren.txt"
TSS = "countries/Tsusin.txt"
TUO = "countries/Tuamotu.txt"
TRN = "countries/Tuaran.txt"
TGA = "countries/Tugana.txt"
TUL = "countries/Tulula.txt"
TUN = "countries/Tungeria.txt"
TUP = "countries/Tupuaii.txt"
TUA = "countries/Turabdia.txt"
TUM = "countries/Turama.txt"
TUR = "countries/Turcia.txt"
TUG = "countries/Turgania.txt"
TUS = "countries/Tuscany.txt"
TUV = "countries/Tuvan.txt"
ULM = "countries/Ulmaroa.txt"
ULO = "countries/Ulotewatu.txt"
UPK = "countries/Upkara.txt"
URA = "countries/Ura.txt"
URB = "countries/Uraba.txt"
URD = "countries/Urdu.txt"
URI = "countries/Uri.txt"
URU = "countries/Uruguay.txt"
USU = "countries/Usurmenia.txt"
UVE = "countries/Uvea.txt"
VAK = "countries/Valkatana.txt"
VAL = "countries/Vallania.txt"
VAN = "countries/Vanuatu.txt"
VAR = "countries/Varisi.txt"
VAA = "countries/Vasa.txt"
VAS = "countries/Vasuguay.txt"
VEL = "countries/Velicia.txt"
VEN = "countries/Venety.txt"
VEP = "countries/Vepsland.txt"
VES = "countries/Vesyria.txt"
VIE = "countries/Vietnam.txt"
VIR = "countries/Virunia.txt"
VIS = "countries/Visaga.txt"
VIT = "countries/Vitu.txt"
WAB = "countries/Wabenakee.txt"
WAG = "countries/Wagalistan.txt"
WAI = "countries/Wagima.txt"
WAH = "countries/Wahibo.txt"
WAJ = "countries/Wajar.txt"
WAE = "countries/Wales.txt"
WAL = "countries/Walpira.txt"
WAU = "countries/Walura.txt"
WAM = "countries/Wambaya.txt"
WAP = "countries/Wampar.txt"
WAN = "countries/Wani.txt"
WAK = "countries/Wanka.txt"
WAR = "countries/Wara.txt"
WEN = "countries/Wendakee.txt"
WER = "countries/Werjikaristan.txt"
WET = "countries/Wetar.txt"
WIN = "countries/Windmark.txt"
WIE = "countries/Winnebagee.txt"
WIR = "countries/Wiru.txt"
WIS = "countries/Wisteria.txt"
WUL = "countries/Wulong.txt"
WUR = "countries/Wurla.txt"
WUO = "countries/Wuton.txt"
WUT = "countries/Wutsang.txt"
WUU = "countries/Wuturupa.txt"
XIN = "countries/Xingu.txt"
YAB = "countries/Yabem.txt"
YAL = "countries/Yallinga.txt"
MYM = "countries/Yam.txt"
YAM = "countries/Yambu.txt"
YAN = "countries/Yanton.txt"
YAR = "countries/Yardili.txt"
YAA = "countries/Yawa.txt"
YAW = "countries/Yawan.txt"
YEK = "countries/Yeke.txt"
YEM = "countries/Yemtland.txt"
YEN = "countries/Yenani.txt"
YEP = "countries/Yeplan.txt"
YET = "countries/Yeta.txt"
YEW = "countries/Yewtung.txt"
YEZ = "countries/Yezow.txt"
YID = "countries/Yiddland.txt"
YOY = "countries/Yoyowat.txt"
YUK = "countries/Yuka.txt"
YUA = "countries/Yuna.txt"
YUN = "countries/Yunnan.txt"
YUR = "countries/Yuronee.txt"
ZAC = "countries/Zacire.txt"
ZAM = "countries/Zambeze.txt"
ZET = "countries/Zetna.txt"
ZUL = "countries/Zula.txt"